1111111111111
1001000C000C1
1P000111E1001
1111111111111
